##tilesets

#tileset
name TILE_50_50
id 1
texture res/img/levels/level1/50_50.png
width 50
height 50
#end

#tileset
name TILE_100_100
id 2
texture res/img/levels/level1/100_100.png
width 100
height 100
#end

#data
2,2,2,2,2,2,2,2,2,2,2,2,2,2,2,2,2,2,2,2
2,0,0,0,0,0,0,0,0,0,0,0,0,0,0,0,0,0,0,2
2,0,0,0,0,0,0,0,0,0,0,0,0,0,0,0,0,0,0,2
2,1,1,0,0,0,0,0,0,0,0,0,0,0,0,0,0,0,0,2
2,1,1,1,0,0,0,0,0,0,0,0,0,0,0,0,0,0,0,2
2,2,1,1,1,1,0,0,0,0,0,0,0,0,0,0,0,0,0,2
2,1,2,1,2,1,1,1,1,1,0,0,0,0,0,0,0,0,0,2
2,1,2,2,1,2,2,2,1,1,1,1,0,0,0,0,0,0,0,2
2,0,0,0,0,0,0,0,0,0,2,1,0,1,1,0,0,0,0,2
2,0,0,0,0,0,0,0,0,0,0,0,0,2,1,0,0,0,0,2
2,0,0,0,0,0,0,0,0,0,0,0,0,0,0,0,0,0,0,2
2,0,0,0,0,0,0,0,0,0,0,0,0,0,0,0,0,1,1,2
2,0,0,0,0,0,0,0,0,0,0,0,0,0,2,1,1,2,2,2
2,0,0,0,0,0,0,1,1,1,1,1,1,1,1,1,2,2,2,2
2,0,0,0,0,0,0,2,2,1,1,1,1,1,2,2,2,2,2,2
2,1,1,0,0,0,0,0,0,0,0,0,0,0,0,0,0,0,0,2
2,1,1,1,1,0,0,0,0,0,0,0,0,0,0,0,0,0,0,2
2,2,1,1,1,1,0,0,0,0,0,0,0,0,0,0,0,0,0,2
2,2,2,2,1,1,1,0,0,0,0,0,0,0,0,0,0,0,0,2
2,2,2,1,2,1,1,1,0,0,0,0,0,0,0,0,0,1,1,2
2,1,2,2,1,2,1,1,1,0,0,0,0,0,0,0,1,1,2,2
2,0,0,0,0,0,0,0,0,0,0,0,0,0,0,1,1,2,2,2
2,0,0,0,0,0,0,0,0,0,0,0,0,1,1,1,1,1,1,2
2,0,0,0,0,0,0,0,0,0,0,0,1,1,2,2,2,1,2,2
2,1,1,0,0,0,0,0,0,0,1,1,1,2,2,2,1,1,1,2
2,1,1,1,1,0,0,0,0,0,0,0,0,0,0,0,0,0,0,2
2,1,2,1,1,1,1,0,0,0,0,0,0,0,0,0,0,0,0,2
2,2,2,2,1,2,1,1,0,0,0,0,0,0,0,0,0,0,0,2
2,1,2,2,2,0,2,0,0,0,0,0,0,0,0,0,0,0,0,2
2,2,2,2,2,2,2,2,2,2,2,2,2,2,2,2,2,2,2,2
#end
