##tilesets

#tileset
name TILE_50_50
id 1
texture res/img/levels/tiles/2_50_50.png
width 50
height 50
#end

#tileset
name TILE_100_100
id 2
texture res/img/levels/tiles/2_100_1.png
width 50
height 50
#end

#tileset
name TILE_1_100_100
id 3
texture res/img/levels/tiles/2_100_2.png
width 50
height 50
#end

#tileset
name TILE_2_100_100
id 4
texture res/img/levels/tiles/2_100_3.png
width 50
height 50
#end

#tileset
name TILE_3_100_100
id 5
texture res/img/levels/tiles/2_100_4.png
width 50
height 50
#end

#data
2,3,2,3,2,3,2,3,2,3,2,3,1,5,2,3,2,3,1,5,2,3,2,3,1,5,2,3,2,3,1,5,2,3,2,3,1,5,2,3,2,3,1,5,2,3,2,3,1,5,2,3,2,3,1,5,2,3,2,3,1,5,2,3,2,3,1,5,2,3,2,3,1,5,2,3,2,3,1,5,2,3,2,3,1,5,2,3,2,3,1,5,2,3,2,3,1,5,2,3
4,5,4,5,4,5,4,5,4,5,4,5,1,5,4,5,4,5,1,5,4,5,4,5,1,5,4,5,4,5,1,5,4,5,4,5,1,5,4,5,4,5,1,5,4,5,4,5,1,5,4,5,4,5,1,5,4,5,4,5,1,5,4,5,4,5,1,5,4,5,4,5,1,5,4,5,4,5,1,5,4,5,4,5,1,5,4,5,4,5,1,5,4,5,4,5,1,5,4,5
2,3,0,0,0,0,0,0,0,0,0,0,0,0,0,0,0,0,0,0,0,0,0,0,0,0,0,0,0,0,0,0,0,0,0,0,0,0,0,0,0,0,0,0,0,0,0,0,0,0,0,0,0,0,0,0,0,0,0,0,0,0,0,0,0,0,0,0,0,0,0,0,0,0,0,0,0,0,0,0,0,0,0,0,0,0,0,0,0,0,0,0,0,0,0,0,0,0,2,3
4,5,0,0,0,0,0,0,0,0,0,0,0,0,0,0,0,0,0,0,0,0,0,0,0,0,0,0,0,0,0,0,0,0,0,0,0,0,0,0,0,0,0,0,0,0,0,0,0,0,0,0,0,0,0,0,0,0,0,0,0,0,0,0,0,0,0,0,0,0,0,0,0,0,0,0,0,0,0,0,0,0,0,0,0,0,0,0,0,0,0,0,0,0,0,0,0,0,4,5
2,3,0,0,0,0,0,0,0,0,0,0,0,0,1,1,1,1,1,1,1,1,1,0,0,0,0,0,0,0,0,0,0,0,0,0,0,0,0,0,0,0,0,0,0,0,0,0,0,0,0,0,0,0,0,0,0,0,0,0,0,0,0,0,0,0,0,1,1,1,1,1,1,1,0,0,0,0,0,0,0,0,0,0,0,0,0,0,0,0,0,0,0,0,0,0,0,0,2,3
4,5,0,0,0,0,0,0,0,0,0,0,0,1,1,1,1,1,1,1,1,1,1,0,0,0,0,0,1,0,0,0,0,0,0,0,1,0,0,0,0,0,0,0,0,0,0,0,0,0,0,0,0,0,0,0,0,0,0,0,0,0,0,0,0,0,1,1,1,1,1,1,1,1,1,0,0,0,1,1,0,0,0,0,0,0,0,0,0,1,1,1,1,0,0,0,0,0,4,5
2,3,0,0,0,0,0,1,1,0,0,0,1,1,1,1,0,0,0,0,0,0,0,0,0,0,0,1,1,1,1,1,1,1,1,1,1,1,0,0,0,0,0,0,0,0,1,1,0,0,0,0,0,0,0,0,0,0,0,0,0,1,1,1,0,0,0,0,0,0,0,0,0,1,1,1,1,1,1,1,1,0,0,0,0,0,0,0,1,1,1,1,1,1,0,0,0,0,2,3
4,5,0,0,0,0,1,1,1,1,1,1,1,1,0,0,0,0,0,0,0,0,0,0,0,0,1,1,1,1,1,1,1,1,1,1,1,1,1,0,0,0,0,0,0,1,1,1,1,0,0,0,0,0,0,0,0,0,0,0,1,1,1,1,1,0,0,0,0,0,0,0,0,0,1,1,1,1,1,1,1,1,1,1,1,1,1,1,1,1,1,1,1,1,1,0,0,0,4,5
2,3,2,3,2,3,2,3,2,3,2,3,2,3,0,0,0,0,0,0,0,0,2,3,1,5,2,3,2,3,1,5,2,3,2,3,1,5,2,3,2,3,1,5,2,3,2,3,1,5,2,3,2,3,1,5,2,3,2,3,1,5,2,3,2,3,1,5,2,3,2,3,1,5,2,3,2,3,1,5,2,3,2,3,1,5,2,3,2,3,1,5,2,3,2,3,1,5,2,3
4,5,4,5,4,5,4,5,4,5,4,5,4,5,4,5,4,5,1,5,4,5,4,5,1,5,4,5,4,5,1,5,4,5,4,5,1,5,4,5,4,5,1,5,4,5,4,5,1,5,4,5,4,5,1,5,4,5,4,5,1,5,4,5,4,5,1,5,4,5,4,5,1,5,4,5,4,5,1,5,4,5,4,5,1,5,4,5,4,5,1,5,4,5,4,5,1,5,4,5
#end